WWWWWWWWWWWWWWWWWWWWWWWWWWWWWWWW
WFFFFFFFFFFFFFFWWFFFFFFFFFFFFFFH
WFFSFFFFFFFFFFFWWFFFFFFFFFFFFFFH
WWWWWWWWWWWWWFFWWFFFFFFFFFFFFFFH
WFFFFFFFFFFFWFFWWFFFFFFFFFFFFFFH
WFFFFFFFFFFFWFFWWFFFFFFFFFFFFFFH
WFFWWWWWWWFFWFFWWFFFFFFFFFFFFFFH
WFFWFFFFEWFFWFFWWFFFFFFFFFFFFFFH
WFFWFFFFEWFFWFFWWFFFFFFFFFFFFFFH
WFFWFFWWWWFFWFFWWFFFFFFFFFFFFFFH
WFFWFFFFFFFFWFFWWFFFFFFFFFFFFFFH
WFFWFFFFFFFFWFFHWFFFFFFFFFFFFFFH
WFFWWWWWWWWWWFFHWFFFFFFFFFFFFFFH
WFFFFFFFFFFFFFFHWFFFFFFFFFFFFFFH
WFFFFFFFFFFFFFFHWFFFFFFFFFFFFFFH
WHHHHWWWWWWWWWWWWFFFFFFFFFFFFFFH
WWWWWWWWWWWWWWWWWFFFFFFFFFFFFFFH
WFFFFFFFFFFFFFFWWFFFFFFFFFFFFFFH
WFFFFFFFFFFFFFFWWFFFFFFFFFFFFFFH
WWWWWWWWWWWWWFFWWFFFFFFFFFFFFFFH
WFFFFFFFFFFFWFFWWFFFFFFFFFFFFFFH
WFFFFFFFFFFFWFFWWFFFFFFFFFFFFFFH
WFFWWWWWWWFFWFFWWFFFFFFFFFFFFFFH
WFFWFFFFEWFFWFFWWFFFFFFFFFFFFFFH
WFFWFFFFEWFFWFFWWFFFFFFFFFFFFFFH
WFFWFFWWWWFFWFFWWFFFFFFFFFFFFFFH
WFFWFFFFFFFFWFFWWFFFFFFFFFFFFFFH
WFFWFFFFFFFFWFFHWFFFFFFFFFFFFFFH
WFFWWWWWWWWWWFFHWFFFFFFFFFFFFFFH
WFFFFFFFFFFFFFFHWFFFFFFFFFFFFFFH
WFFFFFFFFFFFFFFHWFFFFFFFFFFFFFFH
WHHHHWWWWWWWWWWWWHHHHWWWWWWWWWWW