WWWWWWWWWWWWWWWWWWWWWWWWWWWWWWWW
WFFFFFFFFFFFFFFFFFFFFFFFFFFFFFFW
WFFFFFFFFFFFFFFFFFFFFFFFFFFFFFFW
WFFSFFFFFFFFFFFFFFFFFFFFFFFFFFFW
WFFFFFFFFFFFFFFFFFFFFFFFFFFFFFFW
WFFFFFFFFFFFFFFFFFFFFFFFFFFFFFFW
WWWWWWWWWWWWWWWWWWWWWWWWWWWFFFFW
WFFFFFFFFFFFFFFFFFFFFFFFFFWFFFFW
WFFFFFFFFFFFFFFFFFFFFFFFFFWFFFFW
WFFFFFFFFFFFFFFFFFFFFFFFFFWFFFFW
WFFFFFFFFFFFFFFFFFFFFFFFFFWFFFFW
WFFFFFFFFFFFFFFFFFFFFFFFFFWFFFFW
WFFFFHHHHHWWWWWWWWWWWWFFFFWFFFFW
WFFFFHFFFFFFFFFFFFFFFWFFFFWFFFFW
WFFFFHFFFFFFFFFFFFFFFWFFFFWFFFFW
WFFFFHFFFFFFFFFFFFEFFWFFFFWFFFFW
WFFFFWFFFFFFFFFFFFFFFWFFFFWFFFFW
WFFFFWFFFFFFFFFFFFFFFWFFFFWFFFFW
WFFFFWFFFFWWWWWWWWWWWWFFFFWFFFFW
WFFFFWFFFFFFFFFFFFFFFFFFFFWFFFFW
WFFFFWFFFFFFFFFFFFFFFFFFFFWFFFFW
WFFFFWFFFFFFFFFFFFFFFFFFFFWFFFFH
WFFFFWFFFFFFFFFFFFFFFFFFFFWFFFFH
WFFFFWFFFFFFFFFFFFFFFFFFFFWFFFFH
WFFFFWWWWWWWWWWWWWWWWWWWWWWFFFFH
WFFFFFFFFFFFFFFFFFFFFFFFFFFFFFFH
WFFFFFFFFFFFFFFFFFFFFFFFFFFFFFFH
WFFFFFFFFFFFFFFFFFFFFFFFFFFFFFFH
WFFFFFFFFFFFFFFFFFFFFFFFFFFFFFFH
WFFFFFFFFFFFFFFFFFFFFFFFFFFFFFFH
WWWWWWWWWWWWWWWWWWWWWWWHHHHHHHHH
WWWWWWWWWWWWWWWWWWWWWWWWWWWWWWWW