WWWWWWWWWWWWWWWWWWWWWWWWWWWWWWWW
WFFFFFFFFFFFFFFFFFFWFFFFFHFFFFFW
WFFFFFFFFFFFFFFSFFFWFFFFFHFFFFFW
WFFFFWWWWWWWWWWWWWWWFFFFFHFFFFFW
WFFFFWHHHHHHHHHWFFFFFFFFFFFFFFFW
WFFFFWFFFFFFFFFWFFFFFFFFFFFFFFFW
WFFFFWFFFFFFFFFWFFFFFFFFFFFFFFFW
WFFFFWFFFFFFFFFWFFFFFFFFFFFFFFFW
WFFFFWFFFFWFFFFFFFFFFFFFFHFFFFFW
WFFFFWFFFFWFFFFFFFFFFFFFFHFFFFFW
WFFFFWFFFFWFFFFWFFFFFFFFFHFFFFFW
WFFFFFFFFFWWWWWWWWWWWWWWWWWFFFFW
WFFFFFFFFFWFFFFWFFFFFFFFFFFFFFFW
WFFFFFFFFFWFFFFFFFFFFFFFFFFFFFFW
WFFFFFFFFFWFFFFFFFFFFFFFFFFFFFFW
WHHHHHHHHHWFFFFWFFFFFFFFWWWWWWWW
WFFFFFFFFFFFFFFWFFFFFFFFFFFFFFFW
WFFHFFFFFFFFFFFWHHHHHHHHFFFFFFFW
WFFFFFFFFFFFFFFWFFFFFFFFFFFFFFFW
WFFHFFFFFFFFFFFWFFFFFFFFFFFFFFFW
WFFFFFFFFFWFFFFWFFFFFFFFFFFFFFFW
WFFHFFFFFFWFFFFWFFFFFFFFFFFFFFFW
WFFFFFFFFFWFFFFWFFFFFFFFFFFFFFFW
WFFHFFFFFFWFFFFWFFFFFFFHFFFFFFFW
WFFFFFFFFFWWWWWWFFFFFFFHFFFFFFFW
WFFHFFFFFFFFFFFFFFFFFFFHFFFFFFFW
WFFFFFFFFFFFFFFFFFFFFFFHFFFFFFFW
WWWWWWWWWWWWWWWWWHHHHHHHFFFFFFFW
WFFFFFFFFFFFFFFFFFFFFFFFFFFFFFFW
WFEFFFFFFFFFFFFFFFFFFFFFFFFFFFFW
WFFFFFFFFFFFFFFFFFFFFFFFFFFFFFFW
WWWWWWWWWWWWWWWWWWWWWWWWWWWWWWWW