WWWWWWWWWWWWWWWWWWWWWWWWWWWWWWWW
WFFFFWFFFFFFFFFFFFFFFFFFFWFHHFFW
WFFFFFFFFFFFFFFFFFFFFFFFFWFFFHFW
WFFFFFFFFFFFFFFFFFFFFSFFFWFHHHHW
WFFFFFFFFFFFFFFFFFFFFFFFFWFHHHHW
WFFFFWFFFFFFFFFFFFFFFFFFFWFHFHFW
WFFFFWWWWWWWWWWWWWWWWWWWWWWWWWWW
WFFFFFFWHFHFHFFFFFWWWFFFFWFFFFFW
WFFFFFFWFFFFFFFFFFFFFFFFFWFFEFFW
WFFFFFFWHFFFFFFFFFFFFFFFFWFWWWFW
WFFFFWWWWWWWFFFFFFWWWFFFFWFFFFFW
WFFFFFFFFWFFFFFFFFFFWFFFFWFFFFFW
WFFFFFFFFWFFFFFFFFFFWFFFHWFFFFFW
WFFFFFFFFWWWFFFFFFWWWFFFFWWFFFWW
WFFFFWWWFWFFFFFFFFFFWFFFFWFFFFFW
WFFFFFFWFFFFFFFFFFFFWFFFFWFFFFFW
WFFFFFFWFFFFFFFFFFWWWFFFFWFFFFFW
WFFFFFFWFFFFFFFFFFFFWFFFFWFWWWFW
WWWWWWWWWWWWWWWWWWWWWFFFFWFFFFFW
WHFFFFFFFFFWFFFFFFFFFFFFFWFFFFFW
WFFFFFFFFFFWFFFFFFFFFFFFFWFFFFFW
WFFFFFFFFFFWFFFFFFFFFFFFFWWFFFWW
WFFFFFFWFFFFFFFWFFFFFFFFFWFFFFFW
WFFFFFFWFFFFFFFWFFFFFFFFHWFFFFFW
WFFFFFFWFFFFFFFWFFFFFFFHHWFFFFFW
WFFFFFFWWWWWWWWWWWWWWWWWWWFWWWFW
WFFFFFFWFFFFFFFFFFFFFFFFFWFFFFFW
WFFFFFFWFFFFFFFFFFFFFFFFFWFFFFFW
WFFFFFFFFFFFFFFFFFFFFFFFFFFFFFFW
WFFFFFFFFFFFFFFWFFFFFFFFFFFFFFFW
WHFFFFFFFFFFFFWWWFFFFFFFFFFFFFHW
WWWWWWWWWWWWWWWWWWWWWWWWWWWWWWWW