WWWWWWWWWWWWWWWWWWWWWWWWWWWWWWWW
WFFFFFFFFFFFWFFFFFFFFFFFFFFFFFFW
WFFFFFFFFFSFWFEFFFFFFFFFFFFFFFFW
WFFFFFFFFFFFWFFFFFFFFFFFFFFFFFFW
WFFFWWWWWWWWWWWWWWWWWWWWWWWWFFFW
WFFFWFHFHFHFWFFFFFFFFFFFFFFHFFFW
WFFFWFFFFFFFWFFFFFFFFFFFFFFFFFFW
WFFFWFFFFFFFWFFFWFFFFFFFFFFFFFFW
WFFFWFFFWFFFWFFFWFFFFFFFFFFFFFFW
WFFFWFFFWFFFWFFFWFFFFFHFFFFFFFFW
WFFFWFFFWFFFWFFFWWWWWWWWWWWWWWWW
WFFFFFFFWFFFWFFFFFFFFFFFFFFFFHHW
WFFFFFFFWFFFWFFFFFFFFFFFFFFFFFHW
WFFFFFFFWFFFWFFFFFFFFFFFFFFFFFFW
WFHFHFHFWFFFWFFFFFFFFHFFFFFFFFFW
WFFFFFFFFFFFWHFFFFFFHHHFFFFFFFFW
WFFFFFFFFFFFWWWWWWWWWHFFFFFFFFFW
WFFFFFFFFFFFWFFFFFFFFFFFFFFFFFFW
WFFFFWWWWWWWWFFFFFFFFFFFFFFFFFFW
WFFFHWWWWWWWWFFFFFFFFFFFFFFFFFFW
WFFFFWWFFFFWWWWWWWWWFFFWWWWWWWWW
WFFFFWWFHHFWFFFWFFFWFFFWFFFWFFFW
WFFFFWWFHHFWFFFWFFFWFFFWFFFWFFFW
WFFFFWWFFFFWFFFWFFFWFFFWFFFWFFFW
WHFFFWWWWWWWFFFFFFFFFFFFFFFFFFFW
WFFFFFWWWWWFFFFFFFFFFFFFFFFFFFFW
WFFFFFFWWWFFFFFFFFFFFFFFFFFFFFFW
WFFFFFFFWFFFFFFFFFFFFFFFFFFFFFFW
WFFFFFFFFFFFFFFFFFFFFFFFFFFFFFFW
WFFFFFFFFFFFFFFFFFFFFFFFFFFFFFFW
WFFFFFFFFFFFFFFFFFFFFFFFFFFFFFFW
WWWWWWWWWWWWWWWWWWWWWWWWWWWWWWWW