WWWWWWWWWWWWWWWW
WFFFFFFFFFFFFFFW
WFFSFFFFFFFFFFFW
WWWWWWWWWWWWWFFW
WFFFFFFFFFFFWFFW
WFFFFFFFFFFFWFFW
WFFWWWWWWWFFWFFW
WFFWFFFFEWFFWFFW
WFFWFFFFEWFFWFFW
WFFWFFWWWWFFWFFW
WFFWFFFFFFFFWFFW
WFFWFFFFFFFFWFFH
WFFWWWWWWWWWWFFH
WFFFFFFFFFFFFFFH
WFFFFFFFFFFFFFFH
WHHHHWWWWWWWWWWW